11110111111
1000000A001
1C000000001
1E111111111
