11110111111
10000000001
1C000000001
1E111111111
