11111111111111111111
1CCCC0000CCCC0000001
1CCCC0000CCCC0000001
1CCCC000KCCCC0K00001
1CCCC00K0CCCC0000001
10000CCCC0000CCCC001
10000CCCC00K0CCCC001
10000CCCC00K0CCCC001
10000CCCC00K0CCCC001
10000000000000000001
10000000000000000001
10000000000000000001
10000000000000000001
10000000000000000001
10000000000000000PE1
11111111111111111111
