1111111111
1PCCCCCCC1
10000000E1
1111111111
