1111111111
1PCCCCCCC1
100000K0E1
1111111111
